NO ./src/textures/no_wall.xpm
SO ./src/textures/so_wall.xpm



WE ./src/textures/we_wall.xpm
EA ./src/textures/ea_wall.xpm
D ./src/textures/door.xpm
C 0,50,120
F 255,0,255


        1111111111111111111111111
        1000000000110000000000001
        1011000001110 00000000001
        1001000000000000000000001
111111111011000001110000000000001
100000000011000001111112100111111
11113111111111011100000020001
11110111111111011101010010001
11000000111 11011100000010001
1000000000111000000N000010001
10000000000000001101010010001
1100000111010101111101111000111
11110111 1110101 101111010001
11111111 1111111 111111111111
